#17-24
ACTCGTAA	CTGCTTTG
AAACGATA	CATGATCA
TTACCTCG	GGGTAGCG
GCCTGCAA	CCGAGAAA
TGGTATAC	ACGGACTC
CGTTCGAG	ACTTACGA
TCTATTAC	TATTTAAG
ATAAGCTC	ACCGTACG
ATTCATGG	TATAGTCG
ATCCGCGA	TGGGCATC
ATCGCATA	TACCTAGA
CCGTTCTA	GCTGCATG
TGGCGCGC	GTCATATG
TGTCTGAA	ATATTGGC
CTGTCCCG	CTAAGGGA
AATTTCTC	TCGTTTCG
CGCGACTA	GAATAATG
GGGATCGG	ACTGCGCA
TTATTCTG	GCTTATAG
AGGCGGCA	ATCATGCA
ACGCCGGC	ACGTTAAC
TTGTCTTA	CCATCTTG
TACGGTTA	CATAGCTA
TTGGGAGA	GAGGTTGA
TGCTTGGG	GCACTGAC
TAAATATC	TTCATCGC
CACAATTG	GAAATTAG
GTGCTAGC	AGGATTAA
CGCCCGGA	AATAGAAC
GCTCGCGG	TCTTAATC
CTTTGGTC	TAATACGC
TTCCGATC	GTTTGTGA
TTCGCTAC	CGAACGTC
AGCGAAAC	GGTTCTTC
AAATAGCA	GCAAATTC
CGTCTAGG	GCTATGCG
GCCGTGTA	CTACCCTA
CGCTTAAA	GTGGGTTC
GACCTTTC	GTCCGTAG
GGTGGAGC	TGCGATCG
TACTCGAA	TATCCGGG
CATTTGGA	AGGTAATA
GACGGGAC	CGTGGTTG
GTCGCGCG	GACAAAGC
GTTACGTA	GGGCGATG
CTATTTCA	ATCTATAA
ACTATATA	GCCCATGA
TCACTTTA	CTGAAAGG
